%MAP
   XXXX
  XX  XXXXXXXXXXXXX
 XX    .......... X
XX    X  XXXXoXXX XX
X      X X      X  XX
X     X  X ooo  X X XXXXX
XXXXX  X . .X XXX . . . XX
    X   o. .X  X oo o o pX
   XXXXXXX XXX X   XXXXXXX
   X o   o   X XX XXX
   X    o  o X  X XX X XXXX
   X oXXX XXXX  X X X XX  XXXX
   X  o ooo  X XX X  XX      X
   XX        X XX XXXX ooo   X
    XX XXXXXXX .....     XXXXX
    X  o         XXXXXX  X
    X   XXXXXX  XX    XXXX
    XXXXX    XXXX